111111111111111111111111111111
1                       o   1
1                           1
1      1      1   0  1      1     	    
1                 0         1
1                 0         1	
1    O 1      1      1      1
1            0       0      1
1            0       0      1
1      1      1      1      1
1    0                      1
1    0                      1
1    0 1      10000001      1
1             o             1
1                           1
1      1      1      1     o1
1      00000000             1
1                           1
1                    O      1
11111111111111111111111111111
