111111111111111111111111111111
1                       4   1
1                           1
1 0000 1      1   0  1      1     	    
1                 0         1
1                 0         1
1    4 1     01      1      1
1            0       0      1
1            0       0      1
1      1     01      1      1
1    0                      1
1    0                      1
1    0 1      10000001      1
1                           1
1                           1
1      1      1      1      1
1      00000000             1
1                           1
1                    4      1
11111111111111111111111111111
